AMS (Agricultural Management Solutions)|Системы управления сельским хозяйством, сыистемы точного земледелия
abloom|цветущий, в цвету
above-ground|надземная часть
absorb|впитывать, абсорбировать, поглощать
absorption|абсорбция, впитывание, всасывание
absorption capacity of soil|поглотительная способность почвы
abundant|широко распространенный, обильный
accelerate|ускорять(-ся), убыстрять
accumulation|накопление, аккумулирование, скопление
acid|кислота, кислотный, кислый
aminoacid|аминокислота
acid-base balance|кислотно-щелочной баланс
acidity|кислотность
titratable acidity|титруемая кислотность
acre|акр
acreage|площадь в акрах
adapt|приспосабливать (-ся)
add|прибавлять, добавлять
additional|дополнительный
additive|добавка, приправа
adhesion of soil|связность почвы
aerate|аэрировать, насыщать воздухом почву, проветривать
affect|воздействовать на что-то, поражать
afforestation|облесение, лесонасаждение, лесовозобновление
aftercrop|второй урожай
after-ripening|дозревание
aggregate|совокупность, собирать, соединять
aggregated|агрегированный, отструктурированный
aging|вызревание, созревание, выдержка
agriculture|сельское хозяйство, земледелие, агрокультура
agricultural soil science|агропочвоведение
agronomics|агрономия
agronomy|агрономия
agronomist|агроном
agrotechnical level of tilling|агротехнический уровень обработки почв
airtight|герметичный, воздухонепроницаемый
alkali|щёлочь, зола
alkalify|подщелачивать
alkaline|щелочной
allow|позволять, разрешать
alter|изменять, менять, видоизменять, вносить изменения, переделывать
alternate row|промежуточный ряд (растений)
amount|величина, количество
amount of growth|прирост
anaerobic|анаэробный
anchor|закреплять, фиксировать, укореняться
animal husbandry|животноводство
annual|однолетнее растение
aphid|тля
application|применение, внесение
apply|вносить (удобрения)
arable|пашня, пахотная земля
arable land cultivation|обработка пахотных земель
area|площадь, зона, район, область
area of risk farming|зона рискованного земледелия
barren area|пустошь, неплодородный, тощий (о земле)
arid|засушливый, сухой, безводный
aridity|засушливость, аридность
arm|ветвь, отросток, вырост (растения)
artificial|искусственный, синтетический
assess|оценивать, давать оценку
assimilate|поглощать, усваивать
available|доступный, усвояемый
bacterium|бактерия
bacteria|бактерия
bark|кора (дерева)
barn|амбар, сенной сарай, гумно, хлев
barnyard|скотный двор
barnyard manure|навоз со скотного двора
base|основание, нижняя часть (растения)
basic|основной, главный
bear (bore, borne)|производить, плодоносить
bearing|плодоношение, плоды, урожай
beard|ость (колоса)
bed|грядка, место семени в стручке, сажать, высаживать
bedding-out|высаживание, высадка в грунт
beetle|жук, жучок
belt|зона, район, полоса
bench test|лабораторное испытание
berry|ягода, мясистый плод
biennial|двулетник, двулетний
bind (bound)|связывать
biocycle|биоцикл, жизненный цикл
biodegrade|становиться биологически безопасным
black frost|заморозки при сухой погоде
blade|пластинка (листа)
blend|смесь семян разных сортов трав
blight|заболевание растений (завядание, гниение или прекращение роста)
blossom|цвет, цвести, распускаться, расцветать
bog|болотистая почва, верховое болото, торфяник
bogging|заболачивание
bottom|нижняя часть растения
branch|ветвь, ветка, ветвиться
branchy|разветвлѐнный, ветвистый, раскидистый
brand|торговая марка, бренд, маркировать
branded product|маркированное изделие (с фабричной или торговой маркой)
break (broke, broken)|вспахивать, разрыхлять,
break down|лопаться (о почках), распускаться (о бутонах)
breed|разводить, выводить
breeding|селекция, улучшение породы или сорта
bring under cultivation|вводить в культуру
broadcast|посев вразброс, производить посев вразброс
bud|почка, давать почки, окулировать, прививать глазком
budding|окулировка, прививка глазком
bulb|луковица (цветка)
bulky|большой, объемистый
bury|закладывать в почву, закапывать
bush|куст, кустарник, густо разрастаться
bushing|закустаривание
bushel|бушель
by-product|побочный продукт
cabbage|капуста
cabbage white butterfly|капустница, белянка капустная
caked|затвердевший, слежавшийся (о почве)
calcium|кальций
caloricity|калорийность, теплотворная способность
саnе|лоза, стебли кустарников, сахарный тростник
capability|способность
capability of root penetration|проникающая способность корней
capacity|ёмкость, мощность, производительность
carbohydrate|углевод
carbon|углерод
carbon dioxide|двуокись углерода, углекислый газ
cash crop|товарная культура, товарная часть урожая
caterpillar|гусеница
cattle|крупный рогатый скот
cause|причина, причинять, вызывать
cause-and-effect|причинно-следственный
cell|клетка
cereal|зерновые культуры, злаки, хлебный злак
check yield|урожай с контрольной делянки
chemical|химикат
chemicalization|химизация, внедрение химикатов
chemist|химик
cereal chemist|специалист по химии зерна
chlorophyll|хлорофилл
chernozem|чернозѐм, чернозѐмная почва
common (ordinary) chernozem|обыкновенный (средний) чернозѐм
cholesterol|холестерин
circular chromosome|кольцевая хромосома
clay|глина
clay loam|жирный, тяжелый, иловатый суглинок
climate|климат
clipping|скашивание, косьба, подкос
cloddy|комковатый, глыбистый (о почве)
coarse|крупный (о семенах), крупнокомковатый (о почве)
coat|покрывать слоем (чего-л.),
cob|стержень початка кукурузы, початок кукурузы, крупный орех, лещина, фундук
combine|комбайн, убирать комбайном
commodity|продукт, товар, предмет потребления
compact|плотный, уплотнять (почву)
compact soil|связная почва
companion crop|сопутствующая культура
compete|соревноваться, конкурировать
competition|конкуренция, борьба за существование
competitive ability|конкурентоспособность
composition|состав, структура
compost|компост, компостировать, приготовлять компост
compound|состав, смесь, соединение, смешивать, сложный, составной
complete|полный, законченный, заканчивать, завершать
concentrate|концентрат, обогащенный продукт, концентрировать, выпаривать
condition|условие, состояние, кондиция
conifer|хвойное дерево
coniferous|хвойный
connect|соединять (ся), связывать (ся)
connective|связник, связующий, соединительный
conserve|сохранять, сберегать, консервировать
conservation| oхрана природы, рациональное природопользование, рациональное использование природных ресурсов
constituent|составная часть, компонент
constitution|структура, строение
chemical constitution|химический состав
contaminant|загрязнитель, загрязняющее вещество
contaminate|загрязнять, заражать, портить
contamination|примесь, загрязнение, порча, заражение, порча, разложение,
content|содержание (чего-л. в чѐм-л.),, объѐм, вместимость, содержимое доля, процент
continues|непрерывный, постоянный,
control|борьба (с насекомыми, болезнями),v.бороться, контролировать, подавлять
conventional|обычный, общепринятый, традиционный, обусловленный, стандартный, устоявшийся
cooling|охлаждение
corny|зерновой, хлебный, хлеборобный
correlation|корреляция, связь, соотношение, зависимость
correlative|коррелятивный, соответствующий, сходный
corrupt|портиться, гнить, разлагаться, гнилой, порченный
corruptible|способный портиться, портящийся
corruption|порча, гниение, разложение
couch|трава или сорняк с ползучими быстро размножающимися корневищами
couching|выпалывание (сорняков)
country|страна, (сельская) местность, сельский
country of origin|страна происхождения (напр. сорта)
countryside|сельская местность
cover|укрывать, запахивать, заделывать (семена), окучивать
coverage|покров
cow|корова
cowshed|коровник, хлев
cradle|накопитель, оборудование для сбора урожая
cultivated crop|пропашная культура, возделываемая культура
companion crop|культура-уплотнитель
cover crop|покровная культура
industrial crop|техническая культура
crops under glass|тепличные и парниковые культуры
crop production|растениеводство, выращивание с-х культур
crop rotation|севооборот, чередование культур
continuous crop rotation|длительный севооборот
crop rotation experiment|опыт в севообороте
crop rotation farming|плодосменное земледелие
cropping system|система земледелия, система полеводства
cross|скрещивание, скрещивать, гибрид, помесь
crown|ботва, верхушка растений
crumbly|крошащийся, рассыпчатый, хрупкий, ломкий, рыхлый
cultivar|сорт (культурного растения)
cultivate|обрабатывать, возделывать, культивировать, выращивать
cultivated|культурный (о растении), возделываемый (о земле)
cultivation|обработка, культивация, возделывание (земли), рыхление (почвы), культивирование, разведение (растений), выращивание сортов (с.-х. культур), улучшение сортов (с.-х. культур)
culture|с.-х. культура, возделывать с.-х. культуру, культивирование, выращивание (растений), возделывание (почвы)
crop| см. culture
cultural practice|агротехнический прием, метод
cut|надрез, срез
cut-cut|резать, косить, жать, убирать урожай
cycle|период, цикл, круговорот
damage|вред, повреждение, повреждать, приносить ущерб
dangerous|опасный, рискованный
dank|буйно растущий (о травах)
dead|увядший, засохший, растительные остатки
dead plant part|отмершая часть растения
decay|гниль, гниение, разложение, засыхать, увядать, гнить, разлагаться (об органических веществах)
deciduous|опадающий (о листьях), теряющий на зиму листву, лиственный, листопадный (о деревьях)
decompose|разлагать, растворять
decomposition|разложение, разложение, гниение, распад, разрушение
decomposition course|процесс разложения
deforestation|вырубка леса
dehydrator|сушилка, установка для обезвоживания
density|густота, плотность (травостоя, посева), концентрация
deposit|давать осадок, отстой, осадок, нанос, отложение, налѐт
depth|глубина, толща, толщина, мощность (почвы)
desirable|желательный
destroy|уничтожать
destruction|разрушение, уничтожение
detection|выявление, обнаружение, открытие, регистрация
determine|определять, устанавливать
develop|развивать(-ся), совершенствовать, создавать, развивать(-ся), выводить (сорт, породу), разрабатывать
development|создание (сорта), окультуривание (о почве), мелиорация
dew|роса, орошать, увлажнять,
dewfall|выпадение росы
differentiate|различать(-ся), отличать(-ся), видоизменяться
dig|копать
digestible|переваримый, усвояемый
digestion|перегнивание, компостирование, усвоение
dilute|разбавлять, разводить
dioxide|двуокись
carbon dioxide|углекислота
disaster|катастрофа
disastrous|разрушительный
disease|болезнь
disease-producing organism|возбудитель болезни (патоген)
pathogen|патоген
disinfectant|протравитель семян
disk|дисковое орудие, дисковать (почву)
disk harrow|дисковая борона
disperse|рассеивать, разбрасывать, распространять
dissolve|растворять(ся)
distribution|разбрасывание (семян), внесение (удобрений, ядохимикатов)
distributor|высевающий аппарат, разбрасыватель (ядохимикатов, удобрений)
diversity|разнообразие, многообразие, разновидность
division|тип (растений)
do (did, done) well (better, best)|произрастать, хорошо расти (лучше, лучше всего)
domestic|культивируемый (о растениях)
domesticate|окультуривать(растения)
dominant|массовый вид, преобладающая, доминирующая форма
dominate|преобладать, доминировать
dormant|дремлющий, спящий, бездействующий
dormancy|покой (семян, растений), состояние покоя, спячка
drag|борона, бороновать, боронить
drain|осушать (почву), осушитель, дренажная труба
drainage|дренаж, дренирование, осушение
draw|молодой побег
drawn|вытянувшийся, истончѐнный (о всходах, о рассаде)
dress|обрабатывать (землю), удобрять навозом (почву), подкармливать (растения), протравливать (семена), сортировать
dressing|удобрение, навоз, протравливание (семян), сортировка, подкормка (растений)
broadcast dressing|разбросное внесение удобрений
side dressing|междурядная подкормка
soil dressing|корневая подкормка
top dressing|поверхностная подкормка
drill|высевающий аппарат, сеялка, борозда, рядок, высевать, сеять, вносить удобрения в рядки
drilling|рядковый посев, рядковое внесение удобрений
drill row|ряд посева
drop|осыпание, опадение (цветков, завязей, плодов), падалица, высевающий аппарат
droplet|капелька
drought|засуха, сушь
droughty|засушливый, сухой, безводный
dry|сухой
dryer|сушильный аппарат
drum dryer|барабанная сушилка
spray dryer|распылительная сушилка
dry land (dry-land)|засушливый, богарный
due|обусловленный, должный, соответствующий, надлежащий
due to|из-за, вследствие, благодаря
to be due to|обуславливается, объясняться
dung|помёт, навоз, компост, органическое удобрение, удобрять навозом
dunged|удобренный навозом
dunging|внесение навоза, применение органических удобрений
duration|длительность, продолжительность, вегетационный период
dust|вещество в пылеобразном состоянии, дуст, пылевидный препарат, с.-х., брит. отходы, с.-х. опилки, опыливать, агрохим. порошковидный
dust storm|пыльная буря
dwarf|карликовое растение, мешать росту, останавливать развитие
dwarfish|карликовый, низкорослый, недоразвитый
ear|колос, початок (у кукурузы), колоситься
earing|колошение, выколашивание
easy to-root|легко укореняющийся
earthworm|дождевой червь
edaphology|почвоведение
edible|съедобный
effect|следствие, действие, влияние, воздействие, производить, осуществлять (действие, влияние, воздействие)
efficient|действенный, эффективный
eliminate|исключать, уничтожать, ликвидировать
elimination|устранение, удаление, элиминация
embryo|эмбрион, зародыш
emerge|появляться, возникать
emergence|появление, возникновение, всходы
employ|употреблять, применять, использовать
endurance|выносливость, сопротивляемость
endurance limits|пределы выносливости
endure|переносить, выдерживать, противостоять
enduring|выносливый, стойкий (о растениях)
enhance|увеличивать, усиливать
enrich|обогащать, улучшать
enrich soil|удобрять почву
ensure|обеспечивать
environment|окружающая среда
enzyme|фермент, энзим
equipment|оборудование, установка, оснащение
equilibrium|баланс, равновесие
erode|эродировать, выветривать, размывать, разрушать
essential|существенный, весьма важный
establish|создавать, устанавливать, укоренятся, приниматься, разбивать, закладывать
establishment|посев, посадка, создание травостоя
ethanol|этиловый спирт, этанол, этиловый
evaluate|оценивать, определять количество
evaluation|оценка
evaporate|испарять, выпаривать, упаривать, обезвоживать
evaporation|испарение
evergreen|вечнозеленый, вечнозеленое растение
excess|избыток, излишек, излишнее количество
expose|выставлять на свет, подвергать воздействию внешней cреды
exposure|выставление (на солнце), подвержение воздействию среды
extension agency|организация содействия развитию промышленности/ сельского хозяйства
extension service|служба пропаганды сельскохозяйственных знаний и внедрения достижений, служба по распространению опыта и знаний, обучение вольных слушателей
extinction|вымирание
extraction|экстрагирование, извлечение
eye|глазок
facility|оборудование, приспособления, аппаратура, здания (заводов), средства обслуживания
fade|увядать, вянуть, обесцвечивать(ся)
fail|не уродиться (о культуре)
fall|осыпание (семян), осень
fall out of cultivation|дичать, терять культурную форму
fallow|пар, паровое поле, заброшенная пашня, залежь
farming|земледелие, возделывание с-х культур, ведение с-х
fruit farming|плодоводство
favour|благоприятствовать
favourable|благоприятный
feldspar|полевой шпат
female|женский
fertile|плодородный (о почве), изобильный, урожайный
fertility|плодородие (почвы), изобилие, богатство
fertilization|внесение удобрений, подкормка удобрениями
fertilize|удобрять, вносить удобрение, унаваживать
fertilizer|удобрение (минеральное)
fiber|волокно, клетчатка
crude fiber|сырая клетчатка (целлюлоза)
fibrous|мочковатый (корень), волокнистый
field|поле, делянка,
field evaluation|полевая оценка
fine|мелкий, высококачественный, мелкозернистая (о почве)
fine-grained|мелкозернистый
firm|трамбовать, утрамбовывать землю, осевшая, уплотненная почва
firmness|твердость, крепость, прочность, устойчивость
fit for tillage|пригодный для пахоты
flake|вкрапление (небольшое), чешуйка
flat|плоский, нерельефный, однообразный, ровный, гладкий,
fluid|жидкость, жидкий, текучий, подвижный, изменчивый
fluid manure spreader|машина для внесения навозной жижи
fold (four-fold)|кратно (четырехкратно)
forest litter|лесная подстилка, лесной опад
fraction|доля, порция, часть
frame|парник, парниковый сруб
frame grown|парниковый
freeze (froze frozen)|замерзать. замораживать, застывать, затвердевать
frequency|частота, повторяемость
irrigation frequency|план поливов, частота поливов, интервал между поливами
friability of soil|рыхлость, эрозийность почв
frost date|срок наступления заморозков
frostproof date|срок минования весенних заморозков, беззаморозковый период
frost day|день с отрицательной температурой (на поверхности почвы или растений)
frost-hardy (frostproof, frost-resistant)|морозостойкий
frost-killing|вымерзание (растений)
fruit|плод
fleshy fruit|сочный плод
fruitful|плодоносный, плодоносящий, продуктивный, плодородный
fungicide|фунгицид
fungous|грибной, грибковый
fungus (pl. fungi)|гриб, грибок, плесень
furrow|борозда, пахать, нарезать борозды, бороздовать
furrow applicator|машина для внесения ядохимикатов на дно борозды
furrow-making device|бороздоделатель
furrow planter|бороздовая сеялка
furrow spacing|расстояние между бороздами
gain|прирост, увеличение, приобретать
gallon|галлон
gather|сбор, урожай, снимать, собирать, убирать (урожай)
gene|ген
genotype|генотип
germ|зародыш, семя, проросток, почка
germinate|прорастать, развиваться, давать почки
germinating power|всхожесть (семян), энергия прорастания
germination|прорастание (семян), всхожесть, начало роста
germination readiness|энергия прорастания семян
grade|степень, качество, вид, сорт, сортировать, классифицировать, располагать по степени
highgrade|высший класс/сорт
low grade|низкое качество
commercial grade|товарный сорт
soil structure grades|степени оструктуренности почвы
graded|сортовой, сортированный, спланированный (о земле)
grading|классификация, сортировка по качеству, оценка качества
standard|стандарт качества
graft|прививка, привой, привитая часть (растения), прививать, черенковать
grafting wax|садовый вар
grain|зерно, хлебный злак, зерновая культура, зѐрнышко
grinded grain|перемолотое зерно
ground grain|дроблѐное зерно
threshed grain|обмолоченное зерно
grain fill|выполненность зерна
granary|зернохранилище, хлебородный район
grass|трава, злак, дерн, зарастать травой
grasscutter|газонокосилка
grasshopper|саранча, кузнечик
grassland|сенокосное угодье, лугопастбищное угодье
grazing|выпас, пастбище, выгон
greenhouse|теплица, оранжерея
greenhouse gases|газы с тепличным/ парниковым эффектом
green manure crop|культура на зеленое удобрение, сидеральная культура
grit|песчаник, мелкий песок, песчинки, овсяная мука грубого помола, измельчать, грубозернистый
groove|борозда
ground|почва, грунт, участок земли
groundwater|подземные воды, подпочвенные воды, почвенно-грунтовая вода
grow (grew-grown)|расти, произрастать, выращивать, культивировать
growing period (season)|вегетативный период, период вегетации
growth|рост, развитие, произрастание, выращивание, растительность
guard band|защитная полоса (делянка)
guard row|защитный ряд (растений)
gully erosion|овражная эрозия
habit (of growth)|привычка, свойство, особенность развития растения
habitat|естественная среда, место распространения, произрастания
hairs (of roots)|корневые волоски
half-and-half|смесь двух веществ в равных частях,
halt|остановка, прекращение, v останавливать(ся)
harden|становиться жестким, твердеть
harmful|вредный, опасный
harmless|безвредный, безопасный
handle|возделывать, выращивать (растения), обрабатывать (почву), убирать (урожай)
hardiness|выносливость, крепость, устойчивость, жизнестойкость, закаливание (растений), стойкость к неблагоприятным внешним условиям
winter hardiness|зимостойкость
hardiness degree|степень выносливости
hardiness zone|зона морозостойкости
hardness|твердость , жесткость
hardy|стойкий, выносливый, открытого грунта (о растениях)
harrow|борона, боронить
harsh|жесткий, грубый (на ощупь), резкий, неприятный (на вкус)
harvest|урожай, жатва, уборка хлеба, собирать урожай, жать
harvester|комбаин
hay|сено, заготавливать сено
make hay|косить, ворошить и сушить сено
haylage|сенаж, травяной силос, культура на зелѐный корм
hayland|сенокос
hazard|опасность
head|колос, метѐлка (злаковых), колоситься, кочан (капусты), завиваться в кочан
headland|край поля, межа, защитная полоса (делянки)
head row|ряд, засеянный семенами одного колоса или одной метѐлки
heat|тепло (та), жара, нагревать (ся)
heat stability|термоустойчивость
heat treated|термически обработанный
heater|обогреватель, нагревательный прибор
heating|согревающий, обогревающий
heavy soil|тяжѐлая почва, почва тяжѐлого механического состава
hectare|гектар
herb|трава, травянистое растение, надземная часть растений, pl.зелень
herb meadow|разнотравный луг
herbage|травы, травостой, ботва, зелѐная масса (растений)
herbicide|гербицид
herbivore|травоядное (животное)
heredity|наследственность
heritage|наследуемые признаки
high-quality|высококачественный, ant poor-quality
high-speed blades|высокоскоростные лопасти
high-volume|крупносерийный, массовый (о производстве), многостадийный
high-yielding varieties program HYVP|программа выведения высокоурожайных сортов сельскохозяйственных культур
hill|окучивать
hive|улей, пчелиный рой, запасать мѐд
hive products|продукция пчеловодства
hoe|мотыга, культиваторная лапа, v.мотыжить, разрыхлять
homogeneous|однородный, гомогенный
horticulture|садоводство, плодоводство
hotbed|парник, паровая грядка
hull|шелуха, оболочка, пустые стручки, очищать от шелухи, лущить
humid|влажный, сырой
humidity|влажность, влага
humus|гумус, перегной
husbandry|сельское хозяйство, землепашество, хозяйствование
husk|шелуха, скорлупа, мякинная оболочка, v.лущить, шелушить
hybridization|гибридизация, скрещивание
hydroponic|гидропонный
hydroponic bed|гидропонный стеллаж
hydroponic culture|гидропоника
hydroponic plant|гидропонная установка
immature|незрелый, неспелый, слаборазвитый (о почве)
immunity (to)|невосприимчивость, иммунитет
impact|сильное воздействие, влияние
imperishable|прочный, стойкий, непортящийся
implement, tool|инструмент, орудие, принадлежности, инвентарь
improper|непригодный, неподходящий
improve|улучшать(ся), совершенствовать(ся),
improvement|улучшение, усовершенствование
inch|дюйм
include(smth in smth) v|содержать, включать, заключать, содержать в себе,
income|прибыль, заработок, поступление, поступления, доход, выручка,
incorporate|вносить, заделывать (напр., удобрения)
increase(in smth), rise, raise|увеличение, размножение, рост, прирост (чего-л.)
increase|возрастать, увеличивать (ся)
increase in yield|прибавка (урожая),
increase of fertility|повышение плодородия почвы
increase of salinity|повышение засоления
incubate|культивировать (микроорганизмы), выращивать
incubative period of a plant disease|инкубационный период болезни растений
index|показатель, коэффициент
index of irrigation need|показатель потребности в орошении
indigestible|неудобоваримый, трудно перевариваемый
indirect|непрямой, косвенный
infancy|ранняя (начальная) стадия развития (растения).
inferior|худший (по качеству) , плохой
infestation|засорѐнность (посевов), нашествие (вредителей), инвазия
influence|влияние, действие, воздействие на что-то, влиять
inhibit|подавлять, сдерживать, тормозить, задерживать, запрещать
inhabit|населять, обитать
inhabitant|организм, населяющий данную местность
inherit|наследовать
inheritance|наследственность
inhibition|ингибирование, торможение, подавление, угнетение
injure|повреждать
injury|вред, повреждение
intensive grazing|интенсивный выпас
intercrop|промежуточная междурядная культура
interplanting|уплотненный посев, подсев, дополнительная посадка
inter-row|междурядный
inter-row cultivation|междурядная обработка
in tillage|обрабатываемый (о почве)
introduction|интродукция, введение, внедрение (нового сорта, вида)
invasion|инвазия, заселение, вторжение
in vitro|в пробирке
in vivo|в живом организме
involution|дегенерация: закручивание, завѐртывание (листьев)
involve (smb in smth), include, contain|включать в себя, содержать
irreversible consequence|необратимые последствия
irreversibility of evolution|необратимость эволюции
juiciness|сочность
juicy|сочный, спелый, мясистый
keep (kept – kept)|держать, содержать (животных), хранить, сохранять,
keep down|уничтожать (сорняки)
keep up the fertility|поддерживать плодородие почвы
keep|брит. англ. пастбище, подножный корм, запас кормов
kernel milk line|молочная спелость зерна (в основном про кукурузу
kernel percentage|озернѐнность колоса в %
kernel size|величина зерна
kernel smut|головня зерен
kidney|(анат.) почка
kill|уничтожать (сорняки, вредителей), ослаблять
killer|препарат для уничтожения (сорняков, вредителей)
killing frosts|летнее похолодание, заморозки
summer killing|летнее похолодание, заморозки
kind|вид, сорт, отличительный признак
knead|смешивать до получения однородной массы
label|ярлык, этикетка, наклейка, бирка, v категоризировать, относить к какой-л. категории
labour|труд, работа
lack|недостаток, отсутствие (чего-л.)
lack in structure|бесструктурный (о почве)
lactic-acid bacterium (pl bacteria)|молочнокислая бактерия
lactose|(биол.) лактоза, молочный сахар
land|земля, почва, грунт, делянка, землевладение
land use|землепользование
larva|личинка, гусеница
latent|латентный, скрытый, покоящийся, бот. спящий
lateral|боковой побег, боковая плеть
large seeded|крупносеменной
layer|слой, пласт (земли), бот. отводок, стелящийся побег, ярус растительности, v разводить (размножать растения) отводками
leach|v.выщелачивать, высолаживать, вымывать, зола
leaf(pl. leaves)|лист (растения)
leafy|облиственный (о стебле), с хорошо развитой ботвой, лиственный
lean|обеднѐнный (о почве), неурожайный (год)
leggy|вытянувшийся (о рассаде)
legume|растение из семейства бобовых (Leguminosae), боб, плод бобовых, зеленый горошек, столовые овощи, фасоль
legume-grass|бобово-злаковый
leguminous|бобовый
level|уровень, ровный, гладкий, выравнивать
lifter|подъѐмник, машина для уборки корнеплодов
light soil|лѐгкая почва, почва лѐгкого механического состава
lime|известь, известковое удобрение, бот. лайм, липа
limestone|известняк
linseed|льняное семя, лѐн обыкновенный
liquid|жидкий, текучий, жидкость
loaf|кочан (капусты, салата), образовывать кочан
loam|суглинистая почва, супесь, суглинок
leguminous loam|бобовый суглинок
loam-peat compost|торфо-глинистый компост
lodge|полегать (о хлебах, посевах)
longevity of seeds|продолжительность сохранения жизнеспособности семян
loose|рыхлая, сыпучая (порода)
loosen|разрыхлять (почву)
loss|потеря, утрата, убыток, ущерб, потеря
machinery|машины, техника, техническое оборудование
maintain|сохранять, поддерживать, (со) держать
make (made, made)|делать, работать, созидать
make a growth|расти, развиваться
make hay|косить траву на сено
making|работа, ремесло, необходимые качества, изготовление, переработка, процесс изготовления, производство,
maintain|поддерживать, сохранять, обслуживать, содержать в исправности
maintenance|поддержание, сохранение
male|мужской, самец
malformation|неправильное формирование, недостаточное развитие, уродство
malt|солод, солодить, осолаживать
manipulation|обработка, управление (механизмом)
manufacture|производство, процесс изготовления, v производить, изготовлять (промышленным способом), обрабатывать, перерабатывать
matter|вещество
dry matter|сухое вещество
maturation|созревание
mature|взрослый, зрелый (о животном), созревший, спелый (о плодах, семени), созревать, вызревать
maturity|спелость, зрелость
measurement|измерение, замер, размеры
medium|средний (размер), промежуточный
mellow|плодородный, жирный (о почве), рыхлый (о почве), выдержанный (о вине), разрыхлять (почву), спеть, созревать
meltdown|расплавление
middle|борозда, междурядье
mild|мягкий (климат)
mildew|милдью, мучнистая роса
mill|мельница, дробилка, мукомольный комбинат, молоть, дробить (зерно), веять, очищать (семена)
milling|молотьба, дробление, измельчение
mineral|минеральный, насыщенный минеральными веществами, (хим.) неорганический
mixed row|смешанный ряд (растений)
mixer|смеситель, смешивающий аппарат
mixture|перемешивание, смешивание, смесь, мешать, смешивать
moderate|умеренный
moist|влажный
moisture|влага, влажность, сырость
moisture loss|усушка
mold|плесень, гниль, перегной, гумус, плесневеть, гнить
monoculture|бессменная культура, однооборотная культура
moss|мох pl мхи
moth|мотылек, моль, бабочка
mow (mowed mown)|косить, стог, копна, сеновал
mown-out|выкошенный
mower|(сено)косилка
mowing practice|метод скашивания
mulch|дерновый грунт с перегноем, мульча (материал для покрытия почвы), мульчировать
multiply|размножаться, увеличиваться в числе
multiplication|размножение
mushroom|гриб (съедобный)
must|плесень, плесневеть
mycelium|мицелий, грибница
narrow|борона
narrow-row|узкорядный
narrow-row planter|узкорядная сеялка
narrow-row planting|узкорядный посев
nature|природа, основное свойство, сущность
natural selection|естественный отбор
necrogenic|некрогенный, ускоряющий разложение растений
necrosis|некроз, отмирание
nematode|нематода (нитчатый червь)
net|чистый, нетто (о весе, доходе)
net weight|вес нетто, вес без упаковки
nitrate|нитрат, селитра, соль азотной кислоты
nitrogen|натрий
nitrogen fixer|азотофиксатор (бактерия)
nitrogenous|азотный, азотистый
nitroshooter|машина для внесения жидких азотных удобрений
node|узел (на стебле у злаков), колено (ветки, корня), нарост, утолщение
nodule|клубенѐк, узелок, гранула, зерно, нарост на растении
no-grade|не сортовой
non-essential|заменимый, 
non-essential amino acid|заменимая аминокислота
no till|нулевая обработка почвы (перед посевом), гербицидная обработка почвы (без вспашки), беспахотный
nuclear membrane|ядерная оболочка
nucleic acids|нуклеиновые кислоты
nucleous|ядро (клетки), косточка (плода), ядро (ореха)
nursery|питомник, рассадник
nursery seedlings|саженцы, выращенные в питомнике
nursling|сеянец, молодое растение, саженец
nut|орех, плод ореха, собирать орехи
nutrient|питательное вещество
digestible nutrient|усвояемое питательное вещество
nutrient value|питательность
nutrient intensity|концентрация питательных веществ
nutrient lack|недостаток питательных веществ
nutritional, nutritive|относящийся к питанию, пищевой, питательный
nutritious|питательный
obtain|получать, доставать, приобретать
occasional occurrence of species|редкая встречаемость вида
odour|запах, аромат
offal|отходы помола, отруби, высевки, побочные продукты переработки, отбросы, мусор
oil|растительное масло
open-pollinated|перекрѐстноопыляющийся
orchard|фруктовый сад, плодовый питомник
origin|происхождение, источник, род
original|первоначальный, коренной
ornamental|декоративный, орнаментальный, служащий украшением
outbreak|вспышка болезни, эпифитотия, нашествие (с/х вредителей)
outlet|выпускное, выходное отверстие, выпуск, выход, слив, сток
outyield|превосходить по урожайности или продуктивности
overdrill|.подсев, подсевать
overgrowth|гипертрофия, разрастание, заросль
overripe|перезрелый
overrun|избыток
overseed|высевать сверх нормы
oversow (oversowed, oversown)|пересевать, сеять дополнительно, сеять вразброс
overwinter|перезимовывать
oxidation|окисление
oxygen|кислород
oxygent-tolerant|не чувствительный к кислороду
packaging|упаковка, способ упаковки
palatable|аппетитный, вкусный
palatability|вкусовая привлекательность
panning|образование почвенной корки
parasitic|паразитический
parasite|паразит, паразитическое чужеродное растение
plant parasite|растительный паразит
parasitize|паразитировать
parent rock material|почвообразующая порода
particle|частица, крупица (почвы),
particulate|твѐрдая частица, частица жидкости (в эмульсии)
partitioning|разделение, расчленение, разбиение, выделение отделов
pasteurization|пастеризация
pasteurize|пастеризовать
pasteurized|пастеризованный
pasteurized foods|пастеризованные пищевые продукты
pasturage|пастбище, выгон, выпас
pasture|подножный корм, пастбище, выгон, выпас, пастбищные угодья, пастьба, стравливание травостоя, пасти скот, пастись,
pathogen|возбудитель болезни
peat|торф
penetrate|проникать, заглубляться
per prep|за, на, в, с (каждого), (указывает на количество, приходящееся на определенную единицу), 
per year|за год, 
per capita/head|на душу населения
percentage|процент, процентное отношение, процентное содержание
perennial|многолетний, многолетнее растение
performance|продуктивность, производительность, показатель, КПД, работа
perishable|скоропортящийся (продукт), ant imperishable
persistence of pesticide|длительность действия пестицида
pest(s)|сельскохозяйственный вредитель, вредное насекомое, насекомое-паразит, сорняк
pest colonization|заселенность вредителями
pesticide compatibility|совместимость пестицидов
pesticide consumption rate|норма расхода пестицида
pesticide residue|остаточное количество пестицида
petal|лепесток
phenomenon (pl). phenomena|явление
phosphatic|фосфатный
phosphorus|фосфор
photosynthesis|фотосинтез, фотохимический синтез (процесс превращения энергии видимого света в энергию химических связей, сопровождаемый образованием органических соединений и кислорода клетками высших растений из углекислого газа и воды, Ф. происходит с участием различных пигментов (хлорофилл и др)
pickle|рассол, уксус для маринада, мариновать, солить
picker|уборочная машина, плодосъѐмник
picking|сбор (плодов), сортировка (плодов),
pinch|пасынковать, отщипывать, прищипывать (растущие побеги), пинцировать
pistil|пестик
placement|внесение (удобрений), заделка (семян),
plain|равнина, степь, простой, обыкновенный, несмешанный, без добавок
plant|растение, саженец, урожай, травянистое растение (в узком смысле), сажать (растения), сеять, засаживать, устанавливать, внедрять, засевать, озеленять, растительный
parental plant|исходное (родительское) растение
perenial plant|многолетнее растение
potted plant|горшечная рассада
plant breeder|растениевод, селекционер
planter|сеялка
planting|посадка, высадка, посев, сев, культуру, озеленение
plot|делянка, участок (земли),
plow under|запахивать
plowing|вспашка
primary plowing|основная вспашка
pod|боб, стручок, кожура, лузга, образовывать бобы, стручки
podzolized soil|оподзоленная почва
poison|отравлять, заражать, яд, отрава, токсин
poisoning|отравление, интоксикация, применение яда
pollen|пыльца
pollinate|опылять, опылить, с.-х. опыляться
pollination|опыление
pollutant|загрязняющий агент, поллютант
pollute|загрязнять
pollution|загрязнение
porous|пористый
post-emergence|период после появления всходов, послевсходовый
potassic|калийный, калиевый
potassium|калий
pound|фунт (вес) (англ. ф = 453,6 гр)
poultry|домашняя птица
powder|порошок, сухое молоко, измельченное в порошок
practice|прием, метод, способ, технология, применять, практиковать
precipitate|осадок, осаждать(ся)
precipitation|осадки (атмосферные), выпадение осадков
pre-emergence|период перед прорастанием, предвсходовый
preparation|приготовление, подготовка, препарирование, препарат
preserve|сохранять, оберегать, консервировать, заповедник, заказник
preservation|сохранение, консервирование, охрана, защита, предохранение, предупреждение, профилактика
preservative|консервант, консервирующее вещество, фиксатор, антисептик
preserve|хранить, держать (овощи, продукты), заготовлять впрок, консервировать, сохранять, оберегать, консервировать, заповедник, заказник
press|выжимать, прессовать, сдавливать
prevent|предотвращать, предупреждать, препятствовать, мешать
prevention|предотвращение, предохранение, предупреждение
precision agriculture|точное земледелие
precision farming|точное земледелие
primary|основной, главный
prime|превосходный, лучший (сорт, категория)
principal|главный, основной, ведущий
process|процесс, приѐм, способ, технологический процесс, обрабатывать, перерабатывать
processed|переработанный
processing|обработка, переработка (сырья)
procurement|закупки, снабжение, поставка, материально-техническое снабжение, заготовка (сельскохозяйственных продуктов) , лесозаготовка
produce|продукт, продукция, выпуск, объѐм выпуска, производить, вырабатывать
production|производство, продуктивность
productivity, performance|производительность, продуктивность
productive|производительный, продуктивный, эффективный
profile|профиль (почвы)
profile form|строение профиля (почвы)
profitable|прибыльный, рентабельный, доходный
prohibit|запрещать, препятствовать, мешать
proliferate|размножаться (быстро), расти, распространяться, пролиферировать
proliferating|размножающийся, пролиферирующий, процветающий
propagate|размножать (cя), разводить
propagator|теплица для рассады, термостат для проращивания семян
propagules|росток, отпрыск, побег, сеянец, черешок
proper|надлежащий, правильный, должный, подходящий, отвечающий требованиям
property|свойство, качество, отличительная черта, особенность, признак
pedological property|свойство почвы
protectant|протравитель (семян, зерна)
protection|защита, предохранение, охрана
protein|белок, протеин
crude protein|сырой протеин
provide (smb with smth)|обеспечить (кого-л. чем-л.)
to supply|обеспечивать
prune|обрезать (деревья, кусты, ветви), пасынковать
pulverize|распылять, разбрызгивать, разрыхлять (почву)
pump|помпа, насос, качать (насосом)
purification|очищение, очистка
purity|чистота, чистота, беспримесность, правильность
purity of variety|чистота сорта
pure|чистый, без примесей
quality|качество
quality grade|стандарт качества
quantify, measure|определять количество, измерять, мерить
quantitative|количественный
quantity, amount|количество
quartz|кварц
rake|грести, сгребать граблями
rainfall|осадки, ливень
raise|поднимать, выращивать
rancid|прогорклый, протухший (о жирах, мясе)
rancidity|прогорклость, прогорклый запах/вкус
rancidness|прогорклость
random|осуществляемый в произвольной последовательности, с произвольным обращение, случайный, непродуманный, беспорядочный, произвольный, выбранный наугад, бессистемный, разный, смешанный, нерегулярный, рандомизированный
random sampling|произвольная выборка/ взятие образцов
range (from … to)|колебаться в известных пределах
rank|ценить, располагать по рангу, котироваться, занимать какое-л. место
rapid|быстрый, скорый
rate|доза, норма, скорость, быстрота (как физическая характеристика)
ratio|отношение, пропорция, коэффициент, соотношение
raw|сырой, необработанный
raw materials|сырье
recognize|признавать, узнавать
recycling|переработка отходов, повторное использование, использование для другой цели
reduce|ослаблять, понижать, сокращать(ся), уменьшать(ся), убывать
reduction (in smth)|снижение, уменьшение, сокращение (чего-л.)
refrigerating|охлаждающий, холодильный
relationship|взаимоотношение, взаимосвязь
relatively adv.|относительно, сравнительно
relay cropping|сменные уплотнѐнные посевы
release|отпускать, выпускать, освобождать
reliable|надежный, достоверный, заслуживающий доверие
rely (on smb/ smth)|полагаться, рассчитывать (на кого-л./что-л.)
remain|оставаться, находиться, оставаться в каком-л. состоянии
remove|перемещать, убирать, удалять, устранять
replace (by/ with)|заменять, замещать (чем/ кем-л.)
reproduce|размножаться, воспроизводить
reproductive —|репродуктивный, половой
reproductive organ|орган размножения
require (smth)|нуждаться (в чем-л.), требовать (чего-л.)
requirement|требование, необходимое условие, нужда, потребность, to
residue|(хим.) осадок, остаток, остаточный
resilience|устойчивость, жизнестойкость
resistance|устойчивость
resistant|устойчивый, резистентный
resource(-s)|ресурс(ы), средства
natural resources|природные ресурсы
respectively|в указанном порядке, соответственно, соответствующим образом
restrict, limit|ограничивать (в пределах чего-л.)
result (in smth)|приводить (к чему-л.), кончаться (чем-л.), иметь результатом
result from smth|следовать, происходить в результате, происходить от, обуславливаться
retard|замедлять, задерживать, тормозить (развитие и т. п.)
retain|удерживать, задерживать
return|доход, прибыль
ripe|спелый, зрелый
ripen|зреть, созревать
ripening, ageing|вызревание, созревание
rise|повышение, увеличение
rise (rose, risen)|подниматься, возрастать (в объеме)
rock|скальная порода,
roll|прикатывать почву
root|корень, укореняться
rooting|укоренение
root hairs|корневые волоски
rot|гнить, загнивать
rotation|севооборот
rotation interval|интервал севооборота, чередования культур
row|ряд, гряда
row applicator|машина для внесения удобрений в междурядья
row binder|сноповязалка для пропашных культур
row crop production|возделывание пропашных культур
row crop system|пропашная система земледелия
row-crop thinner|прореживатель пропашных культур
row culture|рядковая культура
row drill|рядовая сеялка
row spacing|густота посадки
row tiller|фрезерный культиватор
row width adjustment|регулировка ширины междурядий
rumen|рубец (первый отдел желудка жвачных)
run (ran-run)|януться, расти (о растениях), направлять движение
rust|ржавчина, продукты коррозии, бот. головня, ржа
rye|рожь
saline soil|засоленная почва, солонец
salinity|засоленность (почвы)
salinity level|степень засолѐнности почвы
sampling|отбор проб/ образцов
sandy|песчаный, опесчаненный
sandy loam|суглинок, суглинистая почва, легкий суглинок, опесчаненный суглинок
sanitary|санитарный, гигиенический
sap|сок растения, впитывать
satisfactory|удовлетворительный
satisfy (smb with smth)|удовлетворять (кого-л., чьи-л. требования, запросы)
scarcity(of smth)|недостаток, нехватка (чего-л.)
science|наука
scraps|остатки
scythe|коса, садовая косилка, газонокосилка, выкашивание, косьба, косить
seal|запечатывать, заклеивать, плотно закрывать, образовывать корку
sedimentation|осаждение, отложение осадка
seed|семя, сеять
seed ball|семенной клубочек, шаровидный плод
seedbed|семенное ложе, почва для посева, пашня
seed coat|семенная оболочка
seedless|бескосточковый, бессемянный
seedling|сеянец, проросток, сеянец, саженец (мн.ч. рассада)
seed piece|посадочный клубень (или часть его)
seed vigor|энергия прорастания семян
seeding vigor|всхожесть, мощность прорастания
segregation|отделение, изоляция, отсоединение
select|отбирать, выбирать
self-seeding|самосев
self-pollinated|самоопыляющаяся
semi-arid|полузасушливый
semifrozen|полузамороженный
seminal|семенной, зародышевый
semisoft|полутвердый
sensitive|чувствительный, восприимчивый
separate|отделять, разделять, (хим.) выделять из раствора (отстаиванием)
serum|сыворотка
set (set, set)|сажать (растение, молодой побег растения), завязывать(ся) (о плодах или семенах), завязь (плодов), отрезок корня для посадки, лук-севок, посадочный материал
setting|сгущение, затвердение
severe|суровый
shade tolerance |теневыносливость
shallow|мелкий
shallow-rooted|с неглубокой корневой системой
shape|форма, вид
shatter|осыпаться (о зерне)
shelf life, store life|срок хранения (продукции), срок годности
ship|перевозить (ся), отправлять (ся)
shipment|перевозка товаров
shock|копна (из снопов), скирда
shock gatherer|копноподборщик
shoot|росток, побег
shorten in|укорачивать (ся),
shred (shred)|резать на кусочки
shrink (shrank, shrunk) v|сокращаться, уменьшаться, усыхать
shrinkage|сжатие, сокращение, уменьшение, усушка
side dressing|междурядная подкормка
side effect|побочный эффект
silage|силос, силосовать
silt|ил, осадок, илистое отложение
silt loam|пылеватый суглинок
silt up|заиливать
similar|подобный, похожий, сходный
similarity (among, between, to)|подобие, похожесть, сходство, схожесть
single variety grower|фермер, специализирующийся на выращивании одного сорта какой-л. культуры
size|размер
skim|снимать верхний слой
skin|кожа, шкура, сдирать кожу, шкуру
slight|легкий, слабый
slope|уклон, покатость, наклон, склон,
slug|слизень
small fruits|ягоды
small grains|зерновые культуры (кроме кукурузы)
small plot technique|мелкоделяночный опыт
smoke|коптить
smooth|однородный
smooth body|однородная консистенция
smooth texture|ровная текстура
soak|смачивать, впитывать, всасывать
sod|дерн, пласт
sod formation|дернообразование, задернение
sod soil|дерновая почва
soil|почва, почвенный нанос, почвенный слой, растительная земля, почвенный, грунтовой
soil-building|почвообразование
soil capability|производительность почвы
soil container|ларь для почвенных образцов
soil conservation|охрана почв, охрана и рациональное использование почв, предотвращение эрозии, защита грунта, предотвращение истощения почвы
soil criterion (pl.criteria)|показатель почвы
soil-fertility|плодородие почвы
soil fertility survey|определение запасов питательных веществ в почве
soil-forming factor|фактор почвообразования
soil heterogeneity|неоднородность почвы
soil-inhabiting phytopathogenic fungi |почвообитающий фитопатогеный гриб
soil map|почвенная карта
soil moisture storage|запас почвенной влаги
soil morphology|морфология почвы
soil pH-tester|прибор для определения кислотности почвы
soil-plant-fertilizer relation|треугольник Прянишникова, взаимоотношение почвы, растения и удобрения
soil salinization|засоление (почвы)
solid|твердая частица, твердая фаза, сухой остаток, сухие вещества
solid|твердый (об агрегатном состоянии вещества), чистый, без примесей (о цвете), прочный, крепкий, солидный (чаще всего о телосложении)
solidify|затвердеть, отвердеть, загустевать
soluble|растворимый
fat soluble|жирорастворимый
water soluble|водорастворимый
solution|растворение, раствор
sorghum|сорго
sour|кислый, кисловатый, прокисший, перекисший (испорченный в результате брожения, длительного хранения и т. п.)
source|источник
sow (sowed, sown)|сеять
soybeans|соя
spacing|расстояние, размещение, расположение, расстояние друг от друга, пространство, междурядье, размещать, площадь питания, шаг посадки, шаг посева, шаг расстановки, ширина междурядья
species|вид, род, разновидность
spice|специя, пряность, v приправлять специями
spoilage|порча, гниение пищевых и скоропортящихся продуктов
spray|опрыскивать, распылять, обрызгивать
spread|раскидывать, разбрасывать, устилать, разносить(ся), распространять(ся)
spreadability|консистенция
sprinkle irrigation|орошение дождеванием
spring|произрастать, зарождаться
sprout|росток, пускать ростки, прорастать
stable|конюшня, конский
stage|стадия, этап
stained|пятнистый, имеющий какую-либо окраску
stained zone|окислительно-восстановительная зона
stamen|тычинка
stand|густота всходов, стеблестой, травостой, устоять, выдержать
standard|обычный, стандартный, норма
standard of living |жизненный уровень
standardized|нормализованный
starch|крахмал
starchy|крахмалистый
start|начинать, расти (о растениях)
starter|закваска
bulk starter|производственная закваска
steamed|стерилизованный
stem|стебель, ствол
steppe soil|степная почва
stew|тушиться, томиться (на огне)
stir|мешать, помешивать, размешивать, взбалтывать
stock|подвой
storable|непортящийся (способный сохраняться)
storage|хранение, хранилище, склад
storage life|срок хранения, срок годности
store|запасать, накапливать, сохранять, хранить на складе
store (up)|накапливать, запасать
strain|линия, штамм (для микроорганизмов)
structure|строение, структура, конструкция, устройство
aggregate structure|агрегатная структура
stuff|вещество, материал
subject (to)|подвергать (воздействию, влиянию)
subsoil|подпахотный слой
substance|вещество
substitute|заменитель, заменять, использовать вместо чего-л.
subsurface loosening|безотвальное рыхление
succeeding crop|последующая культура
success|успех
succulent|сочный, мясистый
suffer|страдать
suitable (for smth)|годный, подходящий, пригодный, применимый, соответствующий
sulfur (sulphur)|сера
sulphur dioxide|двуокись серы
sunlight|солнечный свет
sunshine|солнечный свет
superior|лучший, превосходный, высшего качества
supplement|добавление, дополнение, добавки к кормам
nutritive supplement|пищевые добавки
supply|предложение, запас, снабжение, поставка, обеспечение, запасы, общее количество
supply|снабжать, поставлять, обеспечивать, давать
supply (smth) to (smb)|поставлять что-л. кому-л., снабжать кого-л. чем-л.
support (smb/smth)|поддерживать, содействовать, способствовать
surface|поверхность
surplus|избыток, излишек, остаток, излишний, избыточный, добавочный
survive|выжить, пережить
susceptibility|восприимчивость, чувствительность
susceptible (to smth)|восприимчивый, чувствительный (к чему-л.)
sustainable|устойчивый, жизнеспособный
sward|травостой
sweet|сладкий
sweetened|подслащивать, делать сладким
take (took, taken) in oxygen|поглощать кислород
tank-truck loading operation|налив автоцистерны
taste|вкус 
sour to the taste|кислый на вкус
technique|метод, способ, технический прием, технология техника, технические приемы, метод, методика, способ
method|метод, способ, технический прием, технология техника, технические приемы, метод, методика, способ
temporary|временный
temperate|умеренный (о климате)
tend (to/towards)|иметь тенденцию (к чему-л.), склоняться (к чему-л.)
tender|нежный, мягкий (плод)
tenderness|нежность, мягкость
test|проба, испытание, исследование, опыт, анализ, v.пробовать, испытывать
texture|механический состав (почвы), текстура, строение ткани, степень плотности ткани, структура
thaw|таять, оттаивать, размораживать(ся)
thicken|уплотнение, загущение, v.загущать, увеличивать мощность (почвы)
thin|прореживать (посевы), прорывать, букетировать (корнеплодные культуры), топкий, редкий, не густой
thinner|прореживатель, букетировщик
thinning|букетировка, прореживание
thoroughly adv.|тщательно, основательно
thresh|обмолот, молотить, вымолачивать, обмолачивать
thresher|молотилка
threshold|мера чувствительности, порог
tie (up)|подвязывать, привязывать (растения), связывать (питательные вещества)
till|обрабатывать, возделывать (землю), культивировать
tillage|подготовка почвы, обработка почвы, пахота, рыхление, возделанная земля, пашня, запашка, разработка, обработка земли, вспашка, рыхление земли, подготовка почвы (к посеву)
tiller|культиватор, мотыга, фреза
tillage operations|механическая обработка почвы
tilth|глубина вспашки, обрабатываемая земля, пахотная земля, структура почвы, физическая спелость почвы, качество обработки почвы, пригодность почвы к обработке
tilth process|процесс физического созревания (пахотного слоя)
tilth roll|каток для предпосевного прикатывания почвы
tilth stage|стадия физической спелости (почвы)
tilth state|состояние физической спелости (почвы)
tilth-top soil|пахотный слой
timing|выбор времени, конвейер сроков (посева),
tissue|ткань
connective tissue|соединительная ткань
tobacco|табак
tobacco in leaf|листовой табак
tolerant|выносливый, устойчивый, толерантный
top|верхушка, ботва (корнеплодов), надземная часть (растения), верхний
topdressing|поверхностное внесение удобрений, (некорневая) подкормка
topping|прищипывание, пинцировка
top soil|верхний пахотный слой почвы, верхний горизонт
total|весь, целый, полный, общий суммарный
tough|жѐсткий (особенно о пище)
trace|след, незначительное количество, 
trace amount|ничтожно малое количество
trace minerals|микроэлементы
trace elements|микроэлементы
train|формировать (кроны плодовых деревьев и кустарников), направлять рост (растений)
transform|превращать, преобразовать
translocate|передвигать, перемещать
transpiration|транспирация (испарение воды растениями)
transplant|саженец, пикированная рассада, пересаженное растение, пересаживать, пикировать
treat|обрабатывать, протравлять (семена), вносить, применять (удобрения, ядохимикаты)
treatment|уход, обработка, протравление (семян), внесение (удобрений, ядохимикатов)
trial|проба, испытание, исследование, опыт, проверка
tuber|клубень
turf recovery|восстановление дерна
turn|ворошить (сено), перелопачивать (зерно)
turn the soil|распахивать землю
turn under|запахивать
two-row|двухрядный
two-row potato harvester|двухрядный картофелеуборочный комбайн
ultrafiltration|ультрафильтрация (технология очистки воды путѐм фильтрации через сверхтонкие мембраны) 
ultrafiltration concentration|концентрирование ультрафильтрацией
unable (to)|неспособный
undergo (underwent, undergone)|испытывать, подвергаться (чему-л.)
underground|подземный, подпочва
underseeding|подсев
undeveloped|необработанный, неосвоенный (о почве)
undo (undid – undone)|уничтожать (сорняки), губить (рост растений)
uniform|однородный, равномерный, единообразный, дружный (о всходах)
uniformly|единообразно, равномерно (по времени)
unique|уникальный, исключительный, необыкновенный
unsaturated|ненасыщенный
upper|верхний
uproot|вырывать с корнем, выкорчѐвывать, корчевать
use|употребление, применение, польза, использование, использовать, пользоваться, применять, употреблять
utilize|употребление, применение, польза, использование, использовать, пользоваться, применять, употреблять
usefulness|применимость, пригодность
uptake (uptook — uptaken)|поглощать, усваивать, поглощение, усвоение, потребление
urea|мочевина
valuable|полезный, ценный, высоко ценимый
useful|полезный, ценный, высоко ценимый
value|важность, ценность, полезность, стоимость, цена, рыночная цена
nutritional value|питательная ценность
nutritive value|пищевая ценность
importance|важность, ценность, полезность
variety|разновидность, сорт
variety assortment|сортовой состав/ассортимент
variety check|сортовой контроль
variety certificate|сортовое свидетельство
variety certification|аттестация сортности
variety degeneration|вырождение сорта
variety purity|сортовая чистота
variety test plot|сортоиспытательная делянка
variety testing|сортоиспытание
variety trial on a farm scale|производственное сортоиспытание
various|различный, разный, разнообразный
vary|менять(-ся), изменять(-ся), варьировать
differ|менять(-ся), изменять(-ся), варьировать
vary from … to …|изменяться, колебаться в пределах (от … до/ к …)
vary in smth|различаться по (какому-л. признаку), различаться в чем-л. (размере, объеме)
vary with smth|меняться, различаться в зависимости от чего-л., зависеть от чего-л.
vegetation|произрастание, рост, растительность, растительная жизнь, рост, растительный покров, вегетационный
vegetative|вегетативный, вегетационный, растительный, овощной
veterinarian|ветеринарный врач
viable|жизнеспособный
vigour (vigor)|мощь, сила
vigorous|сильный, энергичный (о растениях), мощный (о росте)
vine|лоза, вьющееся растение, виноград, ус, плеть
vine plant|стелющееся растение
vineyard|виноградник
virus|вирус
virusfree|незаражѐнный вирусом
viruslike|вирусоподобный
viscosity|вязкость
visible|видимый, очевидный, явный
vital|жизненный, (жизненно) важный, существенный, необходимый
viticulture|виноградарство
volatile|летучий, быстро испаряющийся
volunteer weeds|самосевные сорняки
walk|пастбище, выгон, выпас
washing|промывка, отмывка
waste|пустыня, пустошь, отходы (производства)
water|вода, водоѐм
waste water|сточные воды
watering|водопой, полив, орошение
waterlogged|заболоченный
water-holding capacilty|водоудерживающая способность
waxing|парафинирование, пропитывание воском, воскование
weed|сорняк, сорная трава, полоть, пропалывать, выпалывать, выдѐргивать сорняки
weedkiller|гербицид
weedicide|гербицид
weed out|уничтожать сорняки
weed seeds|семена сорняков
weigh|взвешивать
weight|вес, масса
weight loss|потеря веса
weighing n|взвешивание, определение массы
wheat|пшеница
winter wheat|озимая пшеница
wheat cultivation technology|технология возделывания пшеницы
whey|сыворотка
whey protein|сывороточный белок
whip|взбивать
whole|цельный
whole kernel corn|цельнозѐрная кукуруза
wholesome|целебный, полезный для здоровья
wholesome food|здоровая пища
wide-row|широкорядный (о посеве)
widespread|широко распространенный
wilding|дичок, дикое растение, одичавшее растение
wilt|вянуть, увядать, поникать, вилт (болезнь увядания)
wind row|валок сжатого хлеба или скошенной травы
winter|v.зимовать, перезимовывать
winter-annual|озимый
winterhardy|зимостойкий
winterkilling|вымерзание (растений)
wireworm|нематода, проволочник
wire-row planting|посев по мерной проволоке
wither|увядать, сохнуть, вянуть, засыхать
withering|вилт, увядание
withstand (withstood – withstood)|сопротивляться, противостоять, выдерживать
year|год
yearling|однолетний саженец, однолетнее растение
yeast|дрожжи, закваска
yield|урожай, размер выработки, выход готовой продукции, количество добытого или произведенного продукта, выход (продукции)
milk yield|надой молока
meat yield|выход мяса
yield gain|повышение урожая
yield per unit|урожай на единицу площади
yield per acre harvested|урожай в расчете на акр убранной площади
zoning|районирование
zootechnician|зоотехник
zyme|фермент